###############
###############
####p##########
####.##########
####.##########
####o##########
####.##########
####.##########
####.##########
####t##########
###############
###############
###############
###############
#.............#
