...............
###############
#.............#
#.........o...#
#t............#
####o.........#
#.p...........#
#.........o...#
#.............#
#....o........#
#########....##
#######t....###
#########tt####
###############
#.............#
