...............
###############
#............t#
#.........o...#
#t............#
####o.........#
#.p....#......#
#......##.o...#
#.......#.....#
#....o..##....#
###.#.####...##
###....t.#..###
##########t####
###############
#.............#
